111111111111
111111111111
11000000CE11
110000000011
110000000011
110000000011
11P000000011
111111111111
111111111111