1111111111111111111111111
1111111111111111111111111
11100000H11V000000C01E111
1110101001100000000010111
1110111C01101100000010111
11100C1001101100000010111
1110001001101100000010111
1000001000001100000010111
1000P01V0000110000000H111
1111111110001111111111111
1111111110001111111111111
1111111111111111111111111