1111111111111111111111111
1111111111111111111111111
11100000V110000000CV1E111
1110101C01100000000010111
1110111001101000000010111
11100C1001101000000010111
1110001001101000000010111
1000001000001H00000010111
1000P01V0000100000V00H111
1111111111111111111111111
1111111111111111111111111
1111111111111111111111111