111111111111111111111
100000V110000000CV1E1
10111C011000000000101
100C10011010000000101
100010011010000000101
100010011010000000101
10001000001H000000101
10P01V0000100000V00H1
111111111111111111111