111111111
111111111
11000CE11
110000011
110000011
110P00011
111111111
111111111