11111111
10010111
10C0E011
1P100C11
11111111