111111111111111111111
100000V1100000000V1E1
101110011000000000101
100010011010000000101
100010011010000000101
100010011010000000101
10001000001H000000101
10P01V0000100000V00H1
111111111111111111111